"a" = (/obj/Vending_Machine,/turf/Floor/Wood_Floor,/area/exercise_room)
"b" = (/obj/Exercise_Equipment/Barbell,/turf/Floor/Wood_Floor,/area/exercise_room)
"c" = (/mob/npc/Picoshong,/turf/Floor/Wood_Floor,/area/exercise_room)
"f" = (/turf,/area)
"g" = (/turf,/area/spooky_area)
"h" = (/turf/Floor/Wood_Floor,/area/exercise_room)
"i" = (/obj/Exercise_Equipment/Treadmill,/turf/Floor/Wood_Floor,/area/exercise_room)

(1,1,1) = {"
gggggggggggggggggggggggggggggggggggggggggggggggggf
gggggggggggggggggggggggggggggggggggggggggggggggggf
gggggggggggggggggggggggggggggggggggggggggggggggggf
gggggggggggggggggggggggggggggggggggggggggggggggggf
gggggggggggggggggggggggggggggggggggggggggggggggggf
gggggggggggggggggggggggggggggggggggggggggggggggggf
gggggggggggggggggggggggggggggggggggggggggggggggggf
gggggggggggggggggggggggggggggggggggggggggggggggggf
gggggggggggggggggggggggggggggggggggggggggggggggggf
gggggggggggggggggggggggggggggggggggggggggggggggggf
gggggggggggggggggggggggggggggggggggggggggggggggggf
gggggggggggggggggggggggggggggggggggggggggggggggggf
gggggggggggggggggggggggggggggggggggggggggggggggggf
gggggggggggggggggggggggggggggggggggggggggggggggggf
gggggggggggggggggggggggggggggggggggggggggggggggggf
gggggggggggggggggggggggggggggggggggggggggggggggggf
gggggggggggggggggggggggggggggggggggggggggggggggggf
gggggggggggggggggggggggggggggggggggggggggggggggggf
gggggggggggggggggggggggggggggggggggggggggggggggggf
gggggggggggggggggggggggggggggggggggggggggggggggggf
gggggggggggggggggggggggggggggggggggggggggggggggggf
gggggggggggggggggggggggggggggggggggggggggggggggggf
gggggggggggggggggggggggggggggggggggggggggggggggggf
gggggggggggggggggggggggggggggggggggggggggggggggggf
gggggggggggggggggggggggggggggggggggggggggggggggggf
hhhhhhhhhhhhhhhhhhhhhhhhhhhhhhgggggggggggggggggggg
hhhhhhhhhhhhhhhhhhhhhhhhhhhhhhgggggggggggggggggggg
hhhhhhhhhhhhhhhhhhhhhhhhhhhhhhgggggggggggggggggggg
hhhhhhhhhhhhhhhhhhhhhhhhhhhhhhgggggggggggggggggggg
hhhhhhhhhhhhhhhhhhhhhhhhhhhhhhgggggggggggggggggggg
hhhhhhhhhhhhahhhahhhhhhhhhhhhhgggggggggggggggggggg
hhhhhhhhhhhhhhhhhhhhhhhhhhhhhhgggggggggggggggggggg
hhhhhhhbhhhhhhhhhhhihhhhhhhhhhgggggggggggggggggggg
hhhhhhhhhhhhhhbhhhhhhhhhhhhhhhgggggggggggggggggggg
hhhhhhhhhhhhhhhhhhihhihhhhhhhhgggggggggggggggggggg
hhhhhhhhhhhhchhhhhhihhhhhhhhhhgggggggggggggggggggg
hhhhhhhhbhhhhhhhhhihhhhhhhhhhhgggggggggggggggggggg
hhhhhhhhhhhhhhhhhhhhhhhhhhhhhhgggggggggggggggggggg
hhhhhhhhhhhhhhhhhhhhhhhhhhhhhhgggggggggggggggggggg
hhhhhhhhhhhhhhhhhhhhhhhhhhhhhhgggggggggggggggggggg
hhhhhhhhhhhhhhhhhhhhhhhhhhhhhhgggggggggggggggggggg
hhhhhhhhhhhhhhhhhhhhhhhhhhhhhhgggggggggggggggggggg
hhhhhhhhhhhhhhhhhhhhhhhhhhhhhhgggggggggggggggggggg
hhhhhhhhhhhhhhhhhhhhhhhhhhhhhhgggggggggggggggggggg
hhhhhhhhhhhhhhhhhhhhhhhhhhhhhhgggggggggggggggggggg
hhhhhhhhhhhhhhhhhhhhhhhhhhhhhhgggggggggggggggggggg
hhhhhhhhhhhhhhhhhhhhhhhhhhhhhhgggggggggggggggggggg
hhhhhhhhhhhhhhhhhhhhhhhhhhhhhhgggggggggggggggggggg
hhhhhhhhhhhhhhhhhhhhhhhhhhhhhhgggggggggggggggggggg
hhhhhhhhhhhhhhhhhhhhhhhhhhhhhhgggggggggggggggggggg
"}
